(                                                .
|                                                |
X|                                              |X
X\                                              |X
X'.                                             |X
XX|                                             |X
XX|                                            |XX
XXX|                                           |XX
XXX|                                           |XX
XXX|                                          |XXX
XXXX|                                         |XXX
XXXX|                                         |XXX
XXXX|                                         |XXX
XXXXX|                                       |XXXX
XXXXX\                                       |XXXX
XXXXX'.                                      |XXXX
XXXXXX|                                     |XXXXX
XXXXXX|                                     |XXXXX
XXXXXXX|                                    |XXXXX
XXXXXXX|                                    |XXXXX
XXXXXXX|                                   |XXXXXX
XXXXXXXX|                                  |XXXXXX
XXXXXXXX|                                  |XXXXXX
XXXXXXXX|                                 |XXXXXXX
XXXXXXXXX|                                |XXXXXXX
XXXXXXXXX|                                /XXXXXXX
XXXXXXXXX'.                              .'XXXXXXX
XXXXXXXXXX|                              |XXXXXXXX
XXXXXXXXXX\                              |XXXXXXXX
XXXXXXXXXXX|                             |XXXXXXXX
XXXXXXXXXXX|                            |XXXXXXXXX
XXXXXXXXXXX|                            |XXXXXXXXX
XXXXXXXXXXXX|                           |XXXXXXXXX
XXXXXXXXXXXX|                          .'XXXXXXXXX
XXXXXXXXXXXX|                          |XXXXXXXXXX
XXXXXXXXXXXXX|                         |XXXXXXXXXX
XXXXXXXXXXXXX|                         |XXXXXXXXXX
XXXXXXXXXXXXX'.                       |XXXXXXXXXXX
XXXXXXXXXXXXXX|                       |XXXXXXXXXXX
XXXXXXXXXXXXXX\                       |XXXXXXXXXXX